OpenStreetMap	OpenStreetMap	固有名詞なので変更しない
QuickStart	クイックスタート	タイトルは統一する
Licence	ライセンス
Styled Layer Descriptor	Styled Layer Descriptor	訳語が定義されていない
Supported Platforms	対応OS
vector data	ベクタデータ	要検討
marker	マーカー
map tile	地図タイル
dynamic map	動的な地図
web page	Webページ
geographic information	地理情報
Open Source	オープンソース
2-clause BSD License	2条項BSDライセンス
redigitise	再デジタル化
political boundaries	政治的境界	国境のほうがいいか？
reference code	リファレンスコード
Semantic Versioning Specification	セマンティック・バージョン付与標準
hydrology	水文学	スイモンガク（地球上の水について循環の観点から研究する学問） (例文： in the areas of hydrology and hydrogeology　水文学と水文地質学の分野で)
landscape development	景観開発
terrain analysis	地形分析
projection	投影
raster data	ラスタデータ
**What will I learn ?**	何を学べますか？
Scale	スケール
inspector	インスペクタ
schema	スキーマ
identifier integrity	識別子の完全性
Software Version	ソフトウェアバージョン
Core Features	主な機能
Details	詳細
Website	Webサイト	2019/080/05長瀬追記 "ウェブサイト"から変更
Supported Platforms	対応プラットフォーム
API Interfaces	API インターフェイス	2019/08/05長瀬追記 "API インタフェース"から変更
Support	サポート
Supported Formats	対応フォーマット
Cartesian	デカルト
Implemented Standards	準拠している標準規格
QuickStart documentation	クイックスタート文書
General Feature Model	General Feature Model	ＯＧＣ用語は訳出しない
Simple Feature	Simple Feature	OGC用語
Grid Coverage	Grid Coverage	OGC用語
Common Constraint Language	Common Constraint Language	OGC用語
Web Feature Service	Web Feature Service	ＯＧＣ用語, WFS
layer	レイヤ
view	ビュー
map	マップ
raster layer	ラスタレイヤ
vector layer	ベクタレイヤ
symbolizer	図案化	検討が必要
choropleth map	階級区分図
polyline	ポリライン
polygon	ポリゴン
corridor	コリドー
billboard	ビルボード
extrusion	押し出し	3Dグラフィックス用語
